10;10
4 4 4 4 4 4 4 4 4 4
4 . . . . . . . . 4
4 . . . . . . . . 4
4 . . . . . . . . 4
4 . . . . . . . . 4
4 3 3 3 . 3 3 3 3 4
4 . . . . . . . . 4
4 . . 5 5 5 5 . . 4
4 . . . . 5 5 . . 4
4 4 4 4 4 4 4 4 4 4
#
4;2;2 
2;0;5 
2;5;4 
0;3;2 
4;6;1 
4;1;2 
4;7;3 
0;4;1 
0;8;9 
5;7;7 
#
