10;10
4 4 4 4 4 4 4 4 4 4
4 . . . . . . . . 4
4 . . . . . . . . 4
4 . . . . . . . . 4
4 . . . . . . . . 4
4 3 3 3 . 3 3 3 3 4
4 . . . . . . . . 4
4 . . 5 5 5 5 . . 4
4 . . . . 5 5 . . 4
4 4 4 4 4 4 4 4 4 4
#
0;4;1 
0;5;2 
1;5;4 
0;7;8 
3;1;6 
0;1;8 
0;6;4 
0;2;3 
0;8;2 
0;5;3 
#
