10;10
4 4 4 4 4 4 4 4 4 4
4 . . . . . . . . 4
4 . . . . . . . . 4
4 . . . . . . . . 4
4 . . . . . . . . 4
4 3 3 3 . 3 3 3 3 4
4 . . . . . . . . 4
4 . . 5 5 5 5 . . 4
4 . . . . 5 5 . . 4
4 4 4 4 4 4 4 4 4 4
#
3;6;4 
2;1;2 
3;7;4 
2;1;6 
1;8;2 
2;3;3 
0;2;1 
1;4;1 
4;3;1 
4;4;8 
#
